+ - - - - - + - - - - - +
| black     | _7        |
+ - - - - - + - - - - - +
| red       | _6        |
+ - - - - - + - - - - - +
| pleïades  | poches    |
+ - - - - - + - - - - - +
| éditeurs  | _1        |
+ - - - - - + - - - - - +
|           | _2        |
| arts      + - - - - - +
|           | _3        |
+ - - - - - + - - - - - +
| _9        | _4        |
+ - - - - - + - - - - - +
| _8        | _5        |
+ - - - - - + - - - - - +


+ - - - - - +
|           |
| arts2     |
|           |
+ - - - - - +
