+ - - - - - + - - - - - +
| black     | _7        |
+ - - - - - + - - - - - +
| red       | _6        |
+ - - - - - + - - - - - +
| pleïades  | poches    |
+ - - - - - + - - - - - +
| éditeurs  | _1        |
+ - - - - - + - - - - - +
|           | _2        |
| arts      + - - - - - +
|           | _3        |
+ - - - - - + - - - - - +
| ital1     | _4        |
+ - - - - - + - - - - - +
| ital2     | _5        |
+ - - - - - + - - - - - +
