+ - - - - + - - - - +
| _A      | _B      |
+ - - - - - + - - - +
| _C      | rowling |
+ - - - - - - - - - +
| _E      | _F      |
+ - - - - - - - - - +
| _G      | _H      |
+ - - - - + - - - - +
| _I      | _J      |
+ - - - - + - - - - +
| _K      | _L      |
+ - - - - + - - - - +
