+ - - - - - - - - + - - - - - - - +
| _A              | hardcovers    |
+ - - - - - - - - - + - - - - - - +
| _C              | rowling       |
+ - - - - - - - - - - - - - - - - +
| _E              | _F            |
+ - - - - - - - - - - - - - - - - +
| _G              | _H            |
+ - - - - - - - - + - - - - - - - +
| berlusconneries | _J            |
+ - - - - - - - - + - - - - - - - +
| _K              | _L            |
+ - - - - - - - - + - - - - - - - +
